Locks=Sperren
AimingStyle=Fadenkreuzsteuerung
BloodLevel=Blutmenge
Lives=Leben
Health=Lebensenergie
LoadingTimes=Nachladezeiten
ChooseWeapons=Waffenauswahl
DeployPlayer=Spieler entsenden
ResetWeapons=Waffen zurücksetzen

have_all_weapons=Du hast bereits alle Waffen!
something_is_bad=Irgendetwas läuft hier gehörig schief
sry_lock_is_on=Ups, die Waffenauswahl ist gesperrt!
sry_lock_is_on2=Ups, die Lebensanzahlsauswahl ist gesperrt!
sry_lock_is_on3=Ups, die Lebensenergieeinstellung ist gesperrt!
sry_lock_is_on4=Ups, die Nachladeschnelligkeitsoption ist gesperrt!
only_one_life=Du hast nur noch ein einziges Leben!
livesleft=Du hast nur noch %d Leben!
Aim_Style=Ziel-Modus ist %d| 1.. drehbar; 2.. Punkt zu Punkt
Blood_Level=Das Blutlevel ist jetzt %d
lives_left_for_player=Spieler %d hat noch %d Leben
voted_for=Ich bin dafür, das %s-Lock %zuschalten
choose_weapon=Wähle Waffe Nummer %d!

#//Lebensenergieeinstellungen
Invincible=Unverwundbar
Very_tough=Sehr robust
Tough=Zäh
Hard=Hart im Nehmen
Normal=Normal
Not_good=Nichts taugend
Very_bad=Wirklich übel
One_shot_one_kill=Ein Schuss, ein Toter

#//Waffen
NapalmThrower=Flammenwerfer
Spray=Explosivspray
DoomsdayRocket=Tag des Jüngsten Gerichts
AntiTankMissile=Panzerfaust
Larpa=Larpa
Blaster=Granatwerfer
Cannon=Kanone
Hellrider=Höllenreiter
MolotovCoctail=Molotowcocktails
Shotgun=Schrotflinte
SuperShotgun=Jagdgewehr
Mines=Minen
Explosives=Sprengladungen
Spikeballs=Zinkenkugeln
Crackler=Prassler
Grenades=Handgranaten
DirtBall=Sandkanone
HandGun=Handfeuerwaffe
Uzi=Uzi